NO ./textures/north_texture.xpm 
EA ./textures/east_texture.xpm 
SO ./textures/south_texture.xpm 
WE ./textures/west_texture.xpm 
F 255, 255, 0
C 0, 255, 255

        
 1111111
 1000001
 1000001
 1000001
 1000001
 100N001
 1000001
 10N0001
 1000001
 1000001
 1000001
 1111111
