NO textures/north_texture.xpm 
EA textures/east_texture.xpm 
SO textures/south_texture.xpm 
WE textures/west_texture.xpm 
F 255, 255, 0
C 0,0,0

                
 111111111111111
 111001000100001
 100000010001001
 100011111110001
 100010000010101
 100010000011101
 101110101001101
 101000101000001
 101010111001001
 101010000000001
 11101000001N101
 111010000000001
 111011110001001
 100011 10000001
 111111 11111111
