NO textures/north_texture.xpm 
EA textures/east_texture.xpm 
SO textures/south_texture.xpm 
WE textures/west_texture.xpm 
F 254, 0, 0
C 0, 0, 255

           
 1111111111
 1000000001
 1000000001
 1000000001
 1000110001
 100N110001
 1000000001
 1000000001
 1000000001
 1111111111
