NO textures/north_texture.xpm 
EA textures/east_texture.xpm 
SO textures/south_texture.xpm 
WE textures/west_texture.xpm 
F 210, 154, 209
C 140, 191, 217

                               
  1111111111111111111111111111 
  1000001111111111111111000001 
  1000011000000000000001000001 
  1000010000000000000011000001 
  1000010000000000000010000001 
  1000010000000000000010000001 
  1000001000000000000010000001 
  100000100000N000000010000001 
  1000001000000000000010000001 
  1000001000000000000010000001 
  1000011000000000000010000001 
  100001000000000111111000001  
   10001111111111000001000001  
   10000000000000000000000001  
   10000000000000000000000001  
   10000000000000000000000001  
   10000000000000000000000001  
   11000000000000000000000001  
    1111111111111111111111101  
                          111  
