NO textures/north_texture.xpm 
EA textures/east_texture.xpm 
SO textures/south_texture.xpm 
WE textures/west_texture.xpm 
F 255, 3, 5
C 5, 5, 5

                
 11111111111    
 10000000001    
 10000000001    
 10000000001    
 10000000001    
 10000000001    
 10000000001    
 10000000001    
 10000000001    
 10000N00001    
 10000000001    
 11111111111    
