NO textures/north_texture.xpm 
EA textures/east_texture.xpm 
SO textures/south_texture.xpm 
WE textures/west_texture.xpm 
F 213, 147, 173
C 0, 0, 200

                               
 111111111111111111111111111111
 101111010000000000000100000001
 100000010000000000000100000001
 100000010000000000000100000001
 100000010000000000000100000001
 100000010000000000000111101111
 100000010000000000000000000001
 100000010000000000000000000001
 100000010000000000000000000001
 100000010000000000000000000001
 100000010000000000000000000001
 100000010000000000000000000001
 100000010000000000000000000001
 100000010000000000000111101111
 100000010000000000000100000001
 100000010000000000000100000001
 100000010000000000000100000001
 100001111111110000000100000001
 111111001100010000000100000001
 100000000000011000000100000001
 100000000000011000000100000001
 100000000000010000000100000001
 100000000000010000000100000001
 100000000000010000000100000001
 100000000000010000000100N00001
 100000000000000000000100000001
 111111110000010000000100000001
 111111110000010000000100000001
 100000000000010000000100111111
 111111111111111111111111111111
