NO textures/fog_texture.xpm 
EA textures/muhammad.xpm 
SO textures/test_texture.xpm 
WE textures/west_texture.xpm 
F 248, 129, 088
C 154, 162, 200

        
 1111111
 1001001
 1001001
 1001001
 1001001
 1001001
 1001001
 1001101
 1001101
 1001101
 1001101
 1001101
 1001101
 1001101
 1001101
 1010001
 1010001
 1010001
 1000001
 10N0001
 1111111
