NO ./textures/north_texture.xpm 
EA ./textures/east_texture.xpm 
SO ./textures/south_texture.xpm 
WE ./textures/west_texture.xpm 
F 0, 0, 0
C 0, 255, 0

                
 111111111111111
 100000111111101
 100000000000001
 100000000000001
 100000000000001
 100000000000001
 100000111000001
 10N000111000001
 100000111000001
 100000000000001
 100000000000001
 100000000000001
 100000000000001
 100000000000001
 111111111111111
