NO textures/north_texture.xpm 
EA textures/east_texture.xpm 
SO textures/south_texture.xpm 
WE textures/west_texture.xpm 
F 255, 0, 0
C 17, 17, 17

                     
         11111       
         100011      
      11110000111    
    11100000000011   
  11100000000000011  
  1100000000000001   
   11000000000001    
    1100000000001    
     110000000001    
     100000000001    
     1N0000000001    
     100000000101    
     100000000101    
     100000000101    
     100000000101    
  111000000000001111 
  100000000000000001 
  100000000000000001 
  110000000000000011 
   1111111111111111  
