NO ./textures/north_texture.xpm
EA ./textures/east_texture.xpm
SO ./textures/south_texture.xpm
WE ./textures/test_texture.xpm
F 18, 0, 0
C 255, 255, 255

              
 1111111111111
 1N10001000101
 1010101010101
 1010101010101
 1010101010101
 1010101010101
 1010101010101
 1010101010101
 1010101010101
 1010101010101
 1010101010101
 1010101010101
 1000100010001
 1111111111111
