NO ./textures/north_texture.xpm



        EA               ./textures/east_texture.xpm


             SO ./textures/south_texture.xpm         



WE ./textures/west_texture.xpm     

F 255            ,0         ,0

         C                    255,30,          0



  111   1111111111111111111111111
 1001   1000000000110000000000001   111111
 11001  1011000001110000000000001   1000111111  
 10101  1001000000000000000000001   1000001
111111111011000001110000000000001   111111
100000000011000001110111111111111
11110111111111011100000010001              1 
11110111111111011101010010001   111       101         
11000000110101011100000010001  111         1  
10000000000000001100000010001
100000N0000000001101010010001    1111    1
1100000111010101111101111000111   1001
11110111 1110101 101111010001    11111
11111111 1111111 111111111111
